25;red;white;blue;blue;yellow;red;black;green;
ççççççççççççççççççççççççç
ççççççççç.......ççççççççç
ççççççç....°.°....ççççççç
ççççç......°.°......ççççç
ççççç......°.°......ççççç
çççç.......°.°.......çççç
çççç...*...°.°...*...çççç
çççç.......°.°.......çççç
ççç....°°°°°.°°°°°....ççç
ççç...°....°.°....°...ççç
ççç..°°.....*.....°°..ççç
çç...°......P......°...çç
çç...°.............°...çç
çç..°°.....°.°.....°°..çç
ç...°.°°°°°...°°°°°.°...ç
ç..°........°........°..ç
ç..°.....°.....°.....°..ç
ç.°..*..°..°.°..°..*..°.ç
ç.°..°.°...°.°...°.°..°.ç
ç.°...°..°.°.°.°..°...°.ç
ç.°°...°.°.°.°.°.°...°°.ç
O.....°.°°.°.°.°°.°.....O
O...*....°°°°°°°....*...O
ççççççç...FFFF....ççççççç
ççççççççççççççççççççççççç