25;red;blue;blue;white;yellow;red;black;green;
#########################
###...#############...###
##.....###########.....##
#..###..#.......#..###..#
#..###...##...##...###..#
#.##.....###.###.....##.#
#.#...*#...#.#...#*...#.#
##...######...######...##
#....#....##.##....#....#
#..........#.#..........#
#.....°.°..#.#..°.°.....#
#....°.°....P....°.°....#
#.*...................*.#
#.......................#
##....#...........#....##
###..##.....F.....##..###
###..##....#.#....##..###
####..##...###...##..####
#####.*...##O##...*.#####
#####..###OO#OO###..#####
######...#######...######
#######..#######..#######
########...###...########
##########.....##########
#########################