25;red;blue;blue;green;white;red;black;yellow;
חחח.אחחחחחחחחחחחחחחחא.חחח
חחח.א....*אאאאא*....א.חחח
חחח.א..אאאאאאאאאאא..א.חחח
חחח.א.אאאאאאאאאאאאא.א.חחח
חחח...אאאאאאאאאאאאא...חחח
חחח.א.אאיאאאאאאאיאא.א.חחח
חחח.א.אאייאאאאאייאא.א.חחח
חחח.א.אאיייאאאיייאא.א.חחח
חחח.א.אאאאאאאאאאאאא.א.חחח
חחח....אא...F...אא....חחח
חחחחחח.אא.יי.יי.אא.חחחחחח
חחחחחח..א.יFFFי.א..חחחחחח
חחחחחחח...ייייי...חחחחחחח
חחחחחחח.א.......א.חחחחחחח
חחחחחח..אאאאאאאאא..חחחחחח
חחחחח..אא.א.א.א.אא..חחחחח
חחחח..א...........א..חחחח
חחח...א.א..א.א..א.א...חחח
חחח..*...א.א.א.א...*..חחח
חחחח...א.אאא.אאא.א...חחחח
חחחחח.אא....P....אא.חחחחח
חחחח..א..אאא.אאא..א..חחחח
חחח..אא..אא...אא..אא..חחח
חח..אא.*אא..א..אא*.אא..חח
חחח.חחאאאחחחחחחחאאאחח.חחח